0 Dirt false 1 0 
1 DirtRough false 1 0 
2 DirtGrass false 1 10 
3 Rock false 1 20 
4 Grass false 1 20 
-------------------------------------
TestMap
40 40

1 1 0 0 0 0 0 0 0 0 0 0 0 0 0 0 0 0 0 0 0 0 0 0 0 0 0 0 0 0 0 0 0 0 0 0 0 0 0 0 
0 0 0 1 1 0 0 2 2 2 0 0 0 0 2 0 0 0 0 0 0 0 0 1 1 0 0 2 2 2 0 0 0 0 2 0 0 0 0 0 
0 0 1 1 1 1 1 0 2 0 0 0 2 0 0 0 2 0 0 0 0 0 1 1 1 1 1 0 2 0 0 0 2 0 0 0 2 0 0 0 
0 0 0 0 1 1 3 3 0 0 0 0 0 0 0 2 0 3 0 0 0 0 0 0 1 1 3 3 0 0 0 0 0 0 0 2 0 3 0 0 
0 2 0 0 1 1 0 3 0 0 0 0 0 0 0 2 2 0 0 0 0 2 0 0 1 1 0 3 0 0 0 0 0 0 0 2 2 0 0 0 
0 0 3 0 0 0 0 0 0 0 0 0 0 0 0 0 0 0 0 0 0 0 3 0 0 0 0 0 0 0 0 0 0 0 0 0 0 0 0 0 
0 0 0 0 0 0 0 0 0 0 0 0 0 0 0 0 2 0 2 0 0 0 0 0 0 0 0 0 0 0 0 0 0 0 0 0 2 0 2 0 
0 0 0 0 0 0 0 0 0 0 0 0 0 0 0 0 0 0 0 0 0 0 0 0 0 0 0 0 0 0 0 0 0 0 0 0 0 0 0 0 
0 0 0 0 0 0 0 0 0 0 0 1 0 0 0 0 0 0 0 0 0 0 0 0 0 0 0 0 0 0 0 1 0 0 0 0 0 0 0 0 
0 0 0 0 0 0 0 0 0 0 0 1 1 0 0 0 0 0 0 0 0 0 0 0 0 0 0 0 0 0 0 1 1 0 0 0 0 0 0 0 
0 0 0 0 0 0 0 0 0 0 0 3 1 1 0 0 0 3 3 1 0 0 0 0 0 0 0 0 0 0 0 3 1 1 0 0 0 3 3 1 
0 0 0 0 0 0 0 0 0 0 0 0 3 0 0 0 0 3 3 1 0 0 0 0 0 0 0 0 0 0 0 0 3 0 0 0 0 3 3 1 
0 0 0 0 0 0 0 0 0 0 0 0 0 3 0 0 0 2 2 1 0 0 0 0 0 0 0 0 0 0 0 0 0 3 0 0 0 2 2 1 
0 0 0 0 0 0 0 0 0 0 0 0 0 0 0 0 0 2 2 1 0 0 0 0 0 0 0 0 0 0 0 0 0 0 0 0 0 2 2 1 
0 2 0 0 0 4 0 0 0 0 0 0 0 0 3 0 2 2 2 0 0 2 0 0 0 4 0 0 0 0 0 0 0 0 0 0 2 2 2 0 
2 2 2 0 4 4 4 4 0 0 0 0 0 0 3 0 0 2 2 0 2 2 2 0 4 4 4 4 0 0 0 0 0 0 0 0 0 2 2 0 
2 2 2 4 4 4 4 0 0 0 0 0 0 0 3 0 0 3 0 0 2 2 2 4 4 4 4 0 0 0 0 0 0 0 0 0 0 3 0 0 
0 0 0 3 3 3 0 0 0 0 0 0 0 3 3 0 3 3 3 0 0 0 0 3 3 3 0 0 0 0 0 0 0 0 0 0 3 3 3 0 
0 0 0 0 3 3 0 0 0 0 0 0 3 3 3 0 3 3 3 0 0 0 0 0 3 3 0 0 0 0 0 0 0 0 0 0 3 3 3 0 
0 0 0 0 0 0 0 0 0 0 0 0 0 3 3 0 0 3 3 0 0 0 0 0 0 0 0 0 0 0 0 0 0 0 0 0 0 3 3 0 
0 0 0 0 0 0 0 0 0 0 0 0 0 0 0 0 0 0 0 0 0 0 0 0 0 0 0 0 0 0 0 0 0 0 0 0 0 0 0 0 
0 0 0 1 1 0 0 2 2 2 0 0 0 0 2 0 0 0 0 0 0 0 0 1 1 0 0 2 2 2 0 0 0 0 2 0 0 0 0 0 
0 0 1 1 1 1 1 0 2 0 0 0 2 0 0 0 2 0 0 0 0 0 1 1 1 1 1 0 2 0 0 0 2 0 0 0 2 0 0 0 
0 0 0 0 1 1 3 3 0 0 0 0 0 0 0 2 0 3 0 0 0 0 0 0 1 1 3 3 0 0 0 0 0 0 0 2 0 3 0 0 
0 2 0 0 1 1 0 3 0 0 0 0 0 0 0 2 2 0 0 0 0 2 0 0 1 1 0 3 0 0 0 0 0 0 0 2 2 0 0 0 
0 0 3 0 0 0 0 0 0 0 0 0 0 0 0 0 0 0 0 0 0 0 3 0 0 0 0 0 0 0 0 0 0 0 0 0 0 0 0 0 
0 0 0 0 0 0 0 0 0 0 0 0 0 0 0 0 2 0 2 0 0 0 0 0 0 0 0 0 0 0 0 0 0 0 0 0 2 0 2 0 
0 0 0 0 0 0 0 0 0 0 0 0 0 0 0 0 0 0 0 0 0 0 0 0 0 0 0 0 0 0 0 0 0 0 0 0 0 0 0 0 
0 0 0 0 0 0 0 0 0 0 0 1 0 0 0 0 0 0 0 0 0 0 0 0 0 0 0 0 0 0 0 1 0 0 0 0 0 0 0 0 
0 0 0 0 0 0 0 0 0 0 0 1 1 0 0 0 0 0 0 0 0 0 0 0 0 0 0 0 0 0 0 1 1 0 0 0 0 0 0 0 
0 0 0 0 0 0 0 0 0 0 0 3 1 1 0 0 0 3 3 1 0 0 0 0 0 0 0 0 0 0 0 3 1 1 0 0 0 3 3 1 
0 0 0 0 0 0 0 0 0 0 0 0 3 0 0 0 0 3 3 1 0 0 0 0 0 0 0 0 0 0 0 0 3 0 0 0 0 3 3 1 
0 0 0 0 0 0 0 0 0 0 0 0 0 3 0 0 0 2 2 1 0 0 0 0 0 0 0 0 0 0 0 0 0 3 0 0 0 2 2 1 
0 0 0 0 0 0 0 0 0 0 0 0 0 0 0 0 0 2 2 1 0 0 0 0 0 0 0 0 0 0 0 0 0 0 0 0 0 2 2 1 
0 2 0 0 0 4 0 0 0 0 0 0 0 0 0 0 2 2 2 0 0 2 0 0 0 4 0 0 0 0 0 0 0 0 0 0 2 2 2 0 
2 2 2 0 4 4 4 4 0 0 0 0 0 0 0 0 0 2 2 0 2 2 2 0 4 4 4 4 0 0 0 0 0 0 0 0 0 2 2 0 
2 2 2 4 4 4 4 0 0 0 0 0 0 0 0 0 0 3 0 0 2 2 2 4 4 4 4 0 0 0 0 0 0 0 0 0 0 3 0 0 
0 0 0 3 3 3 0 0 0 0 0 0 0 0 0 0 3 3 3 0 0 0 0 3 3 3 0 0 0 0 0 0 0 0 0 0 3 3 3 0 
0 0 0 0 3 3 0 0 0 0 0 0 0 0 0 0 3 3 3 0 0 0 0 0 3 3 0 0 0 0 0 0 0 0 0 0 3 3 3 0 
0 0 0 0 0 0 0 0 0 0 0 0 0 0 0 0 0 3 3 0 0 0 0 0 0 0 0 0 0 0 0 0 0 0 0 0 0 3 3 0 

4 4 8 0 4 0 8 8 8 0 4 4 4 4 4 4 4 8 4 0 4 0 8 4 0 8 4 0 8 4 4 8 4 8 4 0 4 4 4 8 
4 4 8 4 4 0 4 4 4 0 4 0 8 4 4 4 4 4 4 8 0 4 8 8 0 8 0 8 0 0 8 4 8 4 8 8 8 4 4 0 
4 4 0 8 0 0 8 0 4 0 0 4 8 4 4 8 8 8 4 4 4 4 4 8 0 8 4 8 4 8 4 4 0 0 8 4 4 4 4 0 
8 8 4 0 4 4 4 8 4 0 8 8 4 0 8 8 4 4 4 4 4 4 4 4 4 4 4 8 4 0 8 8 8 8 4 0 0 4 8 4 
8 4 0 4 0 4 4 4 8 8 4 0 8 0 0 4 0 4 0 0 4 8 4 4 8 8 0 0 4 4 0 4 0 4 4 4 8 4 4 8 
4 0 4 4 0 4 4 0 8 4 0 0 0 4 4 8 4 4 4 4 4 4 8 4 0 0 8 8 0 0 8 4 4 8 4 4 0 8 8 0 
8 4 8 4 8 4 4 0 0 4 8 8 0 4 0 8 8 8 4 4 4 8 0 0 4 8 8 4 4 4 4 0 0 4 4 0 0 8 4 4 
4 0 4 4 4 4 8 4 8 4 0 8 4 4 0 0 4 8 4 4 0 4 0 0 4 4 8 4 4 0 4 0 8 4 4 4 4 0 4 4 
4 4 8 4 4 4 4 0 8 4 0 8 4 8 8 4 0 4 8 4 4 4 4 4 0 0 0 4 4 0 4 8 8 8 4 0 0 8 4 4 
4 8 4 8 0 4 0 4 4 0 8 8 4 4 8 4 8 8 0 8 4 4 8 4 8 4 4 8 8 0 8 8 0 4 4 8 4 4 8 4 
4 8 4 0 0 4 8 0 4 4 8 4 4 4 4 0 4 0 4 4 4 0 4 4 4 4 0 8 8 8 0 0 4 0 4 8 8 8 4 4 
4 0 0 4 4 8 0 8 4 0 4 4 0 8 8 8 4 8 8 4 4 0 8 0 4 0 0 4 0 8 8 4 8 4 0 4 4 8 0 4 
8 8 4 4 4 8 4 4 4 0 4 0 8 8 4 0 4 4 4 4 0 0 8 0 8 8 4 4 4 4 4 0 8 0 0 4 0 4 8 4 
0 4 8 8 4 4 4 0 8 4 4 0 4 0 4 0 4 4 4 8 0 0 4 0 4 0 4 0 4 0 0 8 4 4 0 0 8 4 8 4 
4 4 4 4 0 8 4 0 4 0 4 4 4 4 4 4 4 0 0 4 4 8 0 8 8 0 4 4 0 4 4 4 4 4 4 0 4 8 4 8 
8 4 4 4 4 4 4 8 8 8 4 4 8 8 4 4 4 8 4 8 0 4 0 4 8 0 4 0 4 4 4 4 8 8 4 4 0 8 0 4 
0 4 0 4 4 0 8 8 4 0 0 4 4 4 0 0 4 8 4 4 8 4 4 8 4 0 0 8 4 4 0 4 0 4 4 4 4 0 0 4 
4 0 4 4 4 4 4 0 4 8 4 4 4 4 4 0 0 4 0 4 8 0 4 0 4 8 8 8 4 4 0 4 4 4 8 4 8 4 4 0 
0 8 4 4 4 0 8 0 8 4 4 4 4 8 8 4 0 0 4 0 4 4 4 0 8 8 4 8 4 4 4 0 4 0 4 0 8 8 4 4 
0 0 0 4 8 4 4 4 4 4 0 4 4 4 0 4 4 0 4 4 4 4 4 4 0 8 0 0 4 8 8 0 8 8 4 4 8 0 0 4 
0 4 4 8 4 8 4 4 0 0 4 4 4 8 0 4 8 8 4 4 4 4 4 0 0 4 0 8 4 4 8 0 0 0 8 8 4 4 0 4 
8 0 4 4 4 0 0 4 8 8 0 0 0 8 8 4 4 4 8 4 4 4 4 8 8 8 8 8 4 4 0 0 0 8 4 8 4 8 4 0 
0 0 4 4 4 0 0 0 8 8 8 4 4 0 4 0 4 4 8 4 4 0 8 4 8 0 8 4 4 4 8 4 0 4 4 4 4 4 0 0 
4 4 8 4 8 8 4 8 4 8 0 4 4 4 4 4 4 4 8 0 4 0 4 4 4 4 8 4 0 0 8 8 4 8 0 8 0 4 4 4 
4 4 8 8 4 0 4 0 0 4 4 0 4 8 4 4 0 0 8 0 4 4 8 4 4 4 4 4 0 4 0 4 8 8 4 4 8 0 0 4 
4 0 4 0 4 4 8 0 0 8 8 4 4 0 0 8 4 8 4 0 4 4 8 4 0 4 4 8 4 4 8 0 8 8 4 4 4 0 0 8 
8 4 0 0 8 4 0 0 8 4 0 0 4 0 4 8 4 8 8 0 4 0 4 4 8 4 8 8 4 8 8 0 8 4 8 8 8 0 4 4 
4 8 8 4 8 8 0 0 8 4 0 0 8 0 4 4 8 4 0 4 8 4 0 4 0 8 4 4 8 4 0 0 0 4 8 4 4 0 4 8 
8 8 8 8 0 4 8 4 4 4 4 4 4 0 8 8 4 0 4 8 4 0 4 4 8 4 8 4 4 8 4 0 4 8 4 0 8 0 4 4 
4 4 4 0 4 4 0 8 0 0 4 4 0 4 0 8 0 8 0 0 4 0 8 4 4 4 4 4 4 4 4 4 0 8 4 4 0 8 4 8 
4 0 4 4 4 4 0 0 8 4 0 8 8 8 8 4 8 0 8 4 4 0 8 0 8 4 0 8 0 4 8 4 4 4 4 4 8 8 4 8 
4 0 0 4 0 0 8 4 0 4 0 4 4 8 0 8 4 8 4 8 8 0 4 0 4 0 0 8 4 4 4 8 4 0 4 0 4 8 8 0 
0 4 8 0 8 4 0 8 4 4 4 8 4 0 0 4 0 4 0 4 8 4 4 0 4 4 0 4 0 4 8 4 4 4 4 8 0 4 8 4 
0 8 4 4 4 4 4 4 8 0 0 8 4 8 4 4 8 8 0 4 8 4 4 4 4 4 4 4 8 8 8 8 8 4 8 0 4 8 4 0 
4 8 8 8 0 0 8 4 8 4 4 4 8 4 4 8 8 8 8 4 4 0 4 8 4 4 4 4 8 8 4 0 8 0 0 0 4 0 8 4 
8 4 4 0 8 0 0 4 0 8 0 0 4 0 4 0 0 4 4 4 4 4 4 0 0 0 4 4 8 4 4 0 8 8 4 4 0 8 4 0 
0 4 4 4 4 8 0 4 0 4 0 8 0 4 4 4 0 4 4 0 8 4 8 4 4 4 4 4 0 4 8 0 8 8 8 4 8 4 4 4 
0 0 0 0 4 0 4 4 8 4 0 8 8 4 4 4 0 8 4 4 0 0 0 4 8 4 8 0 0 4 0 4 0 0 8 0 4 0 0 4 
8 8 4 8 4 4 8 4 4 4 0 0 8 8 4 8 4 8 4 4 4 4 8 0 4 4 0 4 4 0 0 4 4 8 0 4 4 4 8 0 
4 8 0 8 4 4 4 0 8 4 4 0 8 4 4 4 4 4 0 0 0 4 4 8 8 4 4 8 0 4 4 4 4 4 8 8 8 0 4 4 

0 0 0 0 0 0 0 0 0 0 0 0 0 0 0 0 0 0 0 0 0 0 0 0 0 0 0 0 0 0 0 0 0 0 0 0 0 0 0 0 
0 0 0 0 0 0 0 0 0 0 0 0 0 0 0 0 0 0 0 0 0 0 0 0 0 0 0 0 0 0 0 0 0 0 0 0 0 0 0 0 
0 0 0 0 0 0 0 0 0 0 0 0 0 0 0 0 0 0 0 0 0 0 0 0 0 0 0 0 0 0 0 0 0 0 0 0 0 0 0 0 
0 0 0 0 0 0 0 0 0 1 0 0 0 0 0 0 0 0 0 0 0 0 0 0 0 0 0 0 0 0 0 0 0 0 0 0 0 0 0 0 
0 0 1 1 1 0 0 0 1 1 1 1 1 0 0 0 0 0 0 0 0 0 0 0 0 0 0 0 0 0 0 0 0 0 0 0 0 0 0 0 
0 0 1 2 1 0 0 0 1 2 2 2 1 1 1 0 0 0 0 0 0 0 0 0 0 0 0 0 0 0 0 0 0 0 0 0 0 0 0 0 
0 0 1 1 1 0 0 0 0 0 2 2 1 1 1 1 0 0 0 0 0 0 0 0 0 0 0 0 0 0 0 0 0 0 0 0 0 0 0 0 
0 0 0 0 0 0 0 0 0 0 0 0 2 2 1 1 0 0 0 0 0 0 0 0 0 0 0 0 0 0 0 0 0 0 0 0 0 0 0 0 
0 0 0 0 0 1 2 2 0 0 0 0 0 0 2 1 0 0 0 0 0 0 0 0 0 0 0 0 0 0 0 0 0 0 0 0 0 0 0 0 
0 0 0 0 1 1 2 2 2 2 0 0 0 0 0 0 0 0 0 0 0 0 0 0 0 0 0 0 0 0 0 0 0 0 0 0 0 0 0 0 
0 0 0 0 1 2 1 1 1 2 2 0 0 0 0 0 0 0 0 0 0 0 0 0 0 0 0 0 0 0 0 0 0 0 0 0 0 0 0 0 
0 0 0 0 0 1 1 1 1 1 2 2 0 0 0 0 0 0 0 0 0 0 0 0 0 0 0 0 0 0 0 0 0 0 0 0 0 0 0 0 
0 0 0 0 0 0 0 0 1 1 1 2 2 0 0 0 0 0 0 0 0 0 0 0 0 0 0 0 0 0 0 0 0 0 0 0 0 0 0 0 
0 0 0 0 0 0 0 0 0 1 1 1 1 0 0 0 0 0 0 0 0 0 0 0 0 0 0 0 0 0 0 0 0 0 0 0 0 0 0 0 
0 0 0 0 1 1 0 0 0 0 1 1 1 0 0 0 0 0 0 0 0 0 0 0 0 0 0 0 0 0 0 0 0 0 0 0 0 0 0 0 
0 0 0 0 0 1 0 0 0 0 0 0 0 0 0 0 0 0 0 0 0 0 0 0 0 0 0 0 0 0 0 0 0 0 0 0 0 0 0 0 
0 0 0 0 0 1 1 1 1 0 0 0 0 0 0 0 0 0 0 0 0 0 0 0 0 0 0 0 0 0 0 0 0 0 0 0 0 0 0 0 
0 0 0 0 1 1 0 0 1 1 1 0 0 0 0 0 0 0 0 0 0 0 0 0 0 0 0 0 0 0 0 0 0 0 0 0 0 0 0 0 
0 0 0 0 1 1 1 0 0 0 1 0 0 0 0 0 0 0 0 0 0 0 0 0 0 0 0 0 0 0 0 0 0 0 0 0 0 0 0 0 
0 0 0 0 1 1 1 1 0 1 1 0 0 0 0 0 0 0 0 0 0 0 0 0 0 0 0 0 0 0 0 0 0 0 0 0 0 0 0 0 
0 0 0 0 0 0 0 0 0 0 0 0 0 0 0 0 0 0 0 0 0 0 0 0 0 0 0 0 0 0 0 0 0 0 0 0 0 0 0 0 
0 0 0 0 0 0 0 0 0 0 0 0 0 0 0 0 0 0 0 0 0 0 0 0 0 0 0 0 0 0 0 0 0 0 0 0 0 0 0 0 
0 0 0 0 0 0 0 0 0 0 0 0 0 0 0 0 0 0 0 0 0 0 0 0 0 0 0 0 0 0 0 0 0 0 0 0 0 0 0 0 
0 0 0 0 0 0 0 0 0 1 0 0 0 0 0 0 0 0 0 0 0 0 0 0 0 0 0 0 0 0 0 0 0 0 0 0 0 0 0 0 
0 0 1 1 1 0 0 0 1 1 1 1 1 0 0 0 0 0 0 0 0 0 0 0 0 0 0 0 0 0 0 0 0 0 0 0 0 0 0 0 
0 0 1 2 1 0 0 0 1 2 2 2 1 1 1 0 0 0 0 0 0 0 0 0 0 0 0 0 0 0 0 0 0 0 0 0 0 0 0 0 
0 0 1 1 1 0 0 0 0 0 2 2 1 1 1 1 0 0 0 0 0 0 0 0 0 0 0 0 0 0 0 0 0 0 0 0 0 0 0 0 
0 0 0 0 0 0 0 0 0 0 0 0 2 2 1 1 0 0 0 0 0 0 0 0 0 0 0 0 0 0 0 0 0 0 0 0 0 0 0 0 
0 0 0 0 0 1 2 2 0 0 0 0 0 0 2 1 0 0 0 0 0 0 0 0 0 0 0 0 0 0 0 0 0 0 0 0 0 0 0 0 
0 0 0 0 1 1 2 2 2 2 0 0 0 0 0 0 0 0 0 0 0 0 0 0 0 0 0 0 0 0 0 0 0 0 0 0 0 0 0 0 
0 0 0 0 1 2 1 1 1 2 2 0 0 0 0 0 0 0 0 0 0 0 0 0 0 0 0 0 0 0 0 0 0 0 0 0 0 0 0 0 
0 0 0 0 0 1 1 1 1 1 2 2 0 0 0 0 0 0 0 0 0 0 0 0 0 0 0 0 0 0 0 0 0 0 0 0 0 0 0 0 
0 0 0 0 0 0 0 0 1 1 1 2 2 0 0 0 0 0 0 0 0 0 0 0 0 0 0 0 0 0 0 0 0 0 0 0 0 0 0 0 
0 0 0 0 0 0 0 0 0 1 1 1 1 0 0 0 0 0 0 0 0 0 0 0 0 0 0 0 0 0 0 0 0 0 0 0 0 0 0 0 
0 0 0 0 1 1 0 0 0 0 1 1 1 0 0 0 0 0 0 0 0 0 0 0 0 0 0 0 0 0 0 0 0 0 0 0 0 0 0 0 
0 0 0 0 0 1 0 0 0 0 0 0 0 0 0 0 0 0 0 0 0 0 0 0 0 0 0 0 0 0 0 0 0 0 0 0 0 0 0 0 
0 0 0 0 0 1 1 1 1 0 0 0 0 0 0 0 0 0 0 0 0 0 0 0 0 0 0 0 0 0 0 0 0 0 0 0 0 0 0 0 
0 0 0 0 1 1 0 0 1 1 1 0 0 0 0 0 0 0 0 0 0 0 0 0 0 0 0 0 0 0 0 0 0 0 0 0 0 0 0 0 
0 0 0 0 1 1 1 0 0 0 1 0 0 0 0 0 0 0 0 0 0 0 0 0 0 0 0 0 0 0 0 0 0 0 0 0 0 0 0 0 
0 0 0 0 1 1 1 1 0 1 1 0 0 0 0 0 0 0 0 0 0 0 0 0 0 0 0 0 0 0 0 0 0 0 0 0 0 0 0 0 